Schoolyard Justice
A poignant tale from the playground by David Celis
Release 1 / Serial number 110709 / Inform 7 build 6G60 (I6/v6.32 lib 6/12N) SD

Playground
You are standing in the playground of Lincoln Elementary School, where you are a student. Other children race around the school yard, brimming with the energy bestowed upon them from a school lunch composed almost entirely of starches and salt. A cacophony of screams and cries ring out across the twisted, metal spires of play structures that rise from the rubbery, plastic mulch. To the north lies the school and the relative safety of being indoors, where there are adults.

A pair of double doors leads into the school.

You can also see a group of children laughing at you here.

>say hello
(to yourself)
There is no reply.

>say hello to children
You can't see any such thing.

>say hello to play structures
You can only do that to something animate.

* * *

>take water pistol
Taken.

>i
You are carrying:
  a water pistol

>look at water pistol
One of the children is holding this small water gun. Based on the size, it was probably quite easy for him to sneak into school.

* * *

>feel pants
You feel nothing unexpected.

* * *

>look pants
Your pants are wet. Interesting... You don't remember wetting yourself. What's going on here?

>look pistol
One of the children you recognize as Jim is holding this small water gun. Based on the size, it was probably quite easy for him to sneak into school.

* * *

>look pants
Your pants are wet. Interesting... You don't remember wetting yourself. What's going on here?

>look swingset
You can't see any such thing.

>school
That's not a verb I recognize.

>enter school
(first opening the double doors)

School Hallway
This is the southern end of your school's main hallway. Various doors in this part of the hall lead to classrooms, but most are closed and locked for recess. One door here leads east to the administrative wing, where the principal, guidance counselors, and other faculty members have offices. Your classroom is further to the north.

A pair of double doors leads back out to the Playground.

>go playground
You can't see any such thing.

>go to playground
You can't see any such thing.

>enter doors
Playground
You are standing in the playground of Lincoln Elementary School, where you are a student. Other children race around the school yard, brimming with the energy bestowed upon them from a school lunch composed almost entirely of starches and salt. A cacophony of screams and cries ring out across the twisted, metal spires of play structures that rise from the rubbery, plastic mulch. To the north lies the school and the relative safety of being indoors, where there are adults.

A pair of double doors leads into the school.

You can also see a group of children laughing at you here.

>look
Playground
You are standing in the playground of Lincoln Elementary School, where you are a student. Other children race around the school yard, brimming with the energy bestowed upon them from a school lunch composed almost entirely of starches and salt. A cacophony of screams and cries ring out across the twisted, metal spires of play structures that rise from the rubbery, plastic mulch. To the north lies the school and the relative safety of being indoors, where there are adults.

A pair of double doors leads into the school.

You can also see a group of children laughing at you here.

* * *

>look school
Your school may as well be a big box made of bricks. There are only a few, small windows, and the building largely resembles a prison. Better in there than out here, though.

* * *

>look at children
The children all appear to be laughing at you. Why? Several of them seem to be pointing to your lower half. You notice that one child is holding a small water pistol.

>look at water pistol
One of the children you recognize as Jim is holding this small water gun. Based on the size, it was probably quite easy for him to sneak into school.

>look down
You see nothing unexpected in that direction.

>look at pants
Jim shot your pants with the water gun so as to make it appear that you wet yourself. Classic.

>cry
That's not a verb I recognize.

* * *

>look at play structures
The playground offers a variety of activites for young children like yourself. There is a swing set, monkey bars, a slide, a seesaw, and even a small merry-go-round where the kids can spin so fast that they vomit.

>look at children
The children all appear to be laughing at you. Why? Several of them seem to be pointing to your lower half. You notice that one child is holding a small water pistol.

* * *

>look at water pistol
One of the children you recognize as Jim is holding this small water gun. Based on the size, it was probably quite easy for him to sneak into school.

>look at pants
Jim shot your pants with the water gun so as to make it appear that you wet yourself. Classic.

>cry
You cry like a little baby. Feel better, little baby?

* * *

>look play structures
The playground offers a variety of activites for young children like yourself. There is a swing set, monkey bars, a slide, a seesaw, and even a small merry-go-round where the kids can spin so fast that they vomit.

* * *

>look at water pistol
That's just the water pistol. Were you expecting something more special?

* * *

>remove pants
You take off the wet pair of pants.

>wear pants
You put on the wet pair of pants.

* * *

>wear pants
You're already wearing that!

>take off pants
You take off the wet pair of pants.

>wear pants
You put on the wet pair of pants.

>wearing a pear of pants
That's not a verb I recognize.

>wear a pair of pants
You're already wearing that!

>take off pants
You take off the wet pair of pants.

>wear a pair of pants
You put on the wet pair of pants.

* * *

>feel
You must supply a noun.

>feel pair of pants
You feel nothing unexpected.

>feel pants
You feel nothing unexpected.

>feel a wet pair of pants
You feel nothing unexpected.

* * *

>feel
You must supply a noun.

>feel me
If you think that'll help.

>feel myself
If you think that'll help.

>feel children
Keep your hands to yourself!

>feel doors
You feel nothing unexpected.

>feel school
You feel nothing unexpected.

>feel pants
You feel nothing unexpected.

* * *

>feel
You must supply a noun.

>feel
(the wet pair of pants)
You feel nothing unexpected.

* * *

>look at school
Ah, good old Lincoln Elementary. You have so many memories of this place. See that water fountain near the doors? Your classmates just love to put their fingers over the spigot and spray you in the face when you try to take a drink. Good times.

>look at water fountain
It's just a water fountain. Aside from the water usually seeming to hit your face instead of your mouth, there's nothing special about it.

* * *

>doors
That's not a verb I recognize.

>enter school
You can't see any such thing.

>enter the school
You can't see any such thing.

>north
(first opening the double doors)

School Hallway
This is the southern end of your school's main hallway. Various doors in this part of the hall lead to classrooms, but most are closed and locked for recess. One door here leads east to the administrative wing, where the principal, guidance counselors, and other faculty members have offices. Your classroom is further to the north.

A pair of double doors leads to the north.

>south
Playground
You are standing in the playground of Lincoln Elementary School, where you are a student. Other children race around the school yard, brimming with the energy bestowed upon them from a school lunch composed almost entirely of starches and salt. A cacophony of screams and cries ring out across the twisted, metal spires of play structures that rise from the rubbery, plastic mulch.

A pair of double doors leads to the north.

You can also see a group of children laughing at you here.

* * *

>doors
That's not a verb I recognize.

>enter doors
(first opening the double doors)

School Hallway
This is the southern end of your school's main hallway. Various doors in this part of the hall lead to classrooms, but most are closed and locked for recess. One door here leads east to the administrative wing, where the principal, guidance counselors, and other faculty members have offices. Your classroom is further to the north.

A pair of double doors leads back out to the Playground.

>doors
That's not a verb I recognize.

>south
Playground
You are standing in the playground of Lincoln Elementary School, where you are a student. Other children race around the school yard, brimming with the energy bestowed upon them from a school lunch composed almost entirely of starches and salt. A cacophony of screams and cries ring out across the twisted, metal spires of play structures that rise from the rubbery, plastic mulch.

A pair of double doors leads into the school.

You can also see a group of children laughing at you here.

>south
You can't go that way.

>exits
That's not a verb I recognize.

>where can i go
That's not a verb I recognize.

>enter school
You can't see any such thing.

>entering the school
That's not a verb I recognize.

>enter the school
You can't see any such thing.

* * *

>cry
That's not a verb I recognize.

>cry children
I only understood you as far as wanting to cry.

* * *

>look at mulch
Seriously, what is this stuff? Rubber? Plastic? One thing's for sure: it's not mulch. Didn't playground used to use sand? Is sand too expensive now or something? These are the questions, man.

* * *

>say hi to children
There is no reply.

>look at children
The children all appear to be laughing at you. Why? Several of them seem to be pointing to your lower half. You notice that one child is holding a small water pistol.

>look north
You see nothing unexpected in that direction.

>look east
You see nothing unexpected in that direction.

* * *

>take pants off
You take off the wet pair of pants.

>wear pants
You put on the wet pair of pants.

* * *

>look at pants
You can't see any such thing.